#S###################
#OOOOOOOOOOO#OOOOOOO#
#######O###O#O###O###
#OOOOOOO#OOO#O#O#OOO#
#O#######O#O#O#O###O#
#OOOOO#OOO#O#O#OOO#O#
#####O#O###O###O#O#O#
#OOOOO#OOO#OOO#O#O#O#
#O#######O###O#O#O#O#
#OOO#OOO#O#O#OOO#O#O#
###O#O#O#O#O#####O#O#
#OOO#O#O#OOOOOOO#OOO#
#O#####O#######O#####
#O#OOO#OOO#OOO#O#OOO#
#O#O#O###O#O#O#O#O#O#
#OOO#OOOOO#O#OOO#O#O#
#O#########O#####O#O#
#OOOOO#OOO#O#OOO#O#O#
###O#O###O#O#O###O#O#
#OOO#OOOOO#OOOOOOO#O#
###################G#
