#S###################
#OOOOOOO#OOOOOOOOOOO#
#######O#####O###O#O#
#OOOOO#O#OOOOO#OOO#O#
#O#O#O#O#O#########O#
#O#O#O#O#OOOOOOOOO#O#
#O#O###O#########O#O#
#O#OOOOO#OOOOOOOOO#O#
#O#######O#O#O#####O#
#O#OOOOOOO#O#O#OOO#O#
#O#O#######O###O#O#O#
#O#O#O#OOO#O#OOO#O#O#
#O#O#O#O#O#O#O###O#O#
#OOO#OOO#O#O#OOO#OOO#
#O#####O#O#O###O#####
#OOOOO#O#OOOOO#O#OOO#
#####O#O#######O#O###
#OOO#O#OOO#OOOOO#OOO#
#O###O###O#O#O#####O#
#OOOOO#OOO#O#OOOOOOO#
###################G#
