#S###################
#OOOOOOOOO#OOOOOOOOO#
###O#####O#O#O#####O#
#O#O#OOO#OOO#O#OOO#O#
#O#O#O#####O#O#O#O#O#
#OOO#OOOOOOO#OOO#O#O#
#O#########O#####O###
#O#OOO#OOO#O#OOO#OOO#
#O#O#O###O#O#O#O###O#
#O#O#O#OOO#OOO#O#OOO#
#O#O#O#O#######O#O#O#
#OOO#O#O#OOOOOOO#O#O#
#O#O#O#O#########O#O#
#O#O#O#O#OOOOO#OOO#O#
#O#O#O#O#O###O#O###O#
#O#O#O#O#O#OOO#O#OOO#
#O###O#O#O#O###O#O###
#OOO#OOO#O#O#OOO#OOO#
###O#####O###O#####O#
#OOOOOOO#OOOOO#OOOOO#
###################G#
