#S###################
#OOOOOOO#OOO#OOOOOOO#
#######O#O#O#O###O###
#OOO#O#OOO#OOO#O#OOO#
#O#O#O#######O#O###O#
#O#OOOOO#OOOOO#OOOOO#
#O#####O#O#####O#####
#OOO#OOO#OOOOO#OOO#O#
###O#O###O###O#O#O#O#
#O#O#OOO#OOO#O#O#OOO#
#O#O###O###O###O#####
#O#OOO#OOO#OOO#O#OOO#
#O#O#O###O###O#O#O#O#
#O#O#OOO#OOO#O#O#O#O#
#O#O#######O#O#O#O#O#
#O#OOO#OOOOO#O#O#O#O#
#O###O#O#####O#O#O###
#OOO#O#OOOOO#O#O#OOO#
#O#O#O#O###O#O#O###O#
#O#OOO#OOO#OOO#OOOOO#
###################G#
