#S###################
#OOO#O#OOOOOOOOOOOOO#
#O#O#O#O#######O#O#O#
#O#O#OOOOOOO#OOO#O#O#
#O#O#O#####O#O#####O#
#O#O#O#OOOOO#O#OOO#O#
#O#O#O#######O#O#O#O#
#O#O#OOO#OOO#OOO#O#O#
#O#O###O#O#O#####O###
#O#OOOOO#O#OOOOO#OOO#
#O#######O#####O###O#
#O#OOOOO#OOO#OOOOOOO#
#O#O#######O#O#####O#
#O#OOOOO#OOO#OOOOO#O#
#O#####O#O###O###O###
#O#O#OOO#OOO#OOO#OOO#
#O#O#O#####O###O###O#
#OOO#OOOOOOO#O#OOO#O#
#O###########O###O#O#
#OOOOOOOOOOO#OOOOO#O#
###################G#
