#S###################
#OOO#OOOOOOOOOOO#OOO#
#O#O#O#O###O#O#O#O#O#
#O#OOO#OOO#O#O#O#O#O#
#####O###O#O#O###O#O#
#OOO#OOO#O#O#O#OOO#O#
#O#O###O#O#O#O#O###O#
#O#OOO#O#O#O#O#O#O#O#
#O###O#O#O#O###O#O#O#
#OOO#O#O#O#OOOOO#OOO#
###O#O#O#O###########
#OOO#O#O#OOOOO#OOOOO#
#O###O#O#####O#O#O#O#
#O#OOOOO#OOO#OOO#O#O#
#O#O#####O#O#######O#
#O#OOOOOOO#O#O#OOO#O#
#O#########O#O#O#O#O#
#OOOOOOO#O#O#O#O#O#O#
###O###O#O#O#O#O###O#
#OOOOO#OOO#OOO#OOOOO#
###################G#
