#S###################
#OOOOOOOOOOOOOOOOOOO#
#########O#O#######O#
#OOO#OOOOO#O#O#OOOOO#
###O#O###O#O#O#O#O###
#OOO#OOO#O#O#OOO#OOO#
#O#####O#O#O#######O#
#OOOOOOO#O#OOOOO#O#O#
###############O#O#O#
#OOO#OOO#OOOOOOO#OOO#
#O###O#O#O###########
#OOO#O#OOOOO#OOOOOOO#
#O#O#O#####O#O#####O#
#O#O#OOOOO#OOO#OOOOO#
#O#O#####O#####O#####
#O#O#OOOOO#OOO#OOOOO#
###O#O#O###O#######O#
#OOO#O#O#OOO#OOOOOOO#
#O###O#O#O###O#######
#OOOOO#O#OOOOOOOOOOO#
###################G#
