#S###################
#OOOOO#OOOOOOOOOOOOO#
#####O#O#####O#O#####
#OOO#O#OOOOO#O#OOOOO#
#O#O#O#######O#####O#
#O#OOO#OOOOO#O#OOOOO#
#O#####O###O#O#O#####
#OOO#OOO#O#OOO#OOOOO#
#O###O###O#######O#O#
#O#OOO#OOO#OOO#OOO#O#
#O#O#O#O###O#O#O###O#
#OOO#O#OOO#O#OOO#OOO#
#####O#O#O#O#####O###
#OOO#O#O#OOOOO#OOO#O#
#O#O#O#O#####O#O###O#
#O#O#O#OOOOO#O#O#O#O#
###O#O#O###O#O#O#O#O#
#OOO#O#O#O#O#O#OOOOO#
#O###O#O#O#O#########
#OOOOO#OOO#OOOOOOOOO#
###################G#
