#S###################
#OOOOO#OOOOOOO#OOOOO#
#O###O#O#####O#O###O#
#OOO#OOO#OOOOO#OOO#O#
#O#O#####O#########O#
#O#O#OOOOO#OOOOOOOOO#
###O#O#O###O#O#######
#OOO#O#OOOOO#OOOOO#O#
#O###############O#O#
#OOO#OOOOOOOOOOO#OOO#
#O#O#O#########O#####
#O#O#O#OOOOOOO#O#OOO#
#O###O#O###O#O#O#O#O#
#OOO#OOOOO#O#O#O#O#O#
#O#O#####O#O#O#O###O#
#O#OOOOOOO#O#O#OOOOO#
#O###########O#######
#O#OOO#O#OOOOO#OOO#O#
#O#O#O#O#O#####O#O#O#
#OOO#OOO#OOOOOOO#OOO#
###################G#
