#S###################
#OOOOO#OOOOOOOOO#OOO#
#####O#O###O###O#O#O#
#OOO#OOOOO#OOO#OOO#O#
#O#O#####O###O#####O#
#O#OOOOO#OOO#O#OOOOO#
#O#O###O###O#O#O#####
#O#OOO#OOO#O#O#OOOOO#
#O#O#####O###O#####O#
#O#O#OOO#OOO#OOOOO#O#
#O###O#O###O#####O###
#OOO#O#OOO#OOOOO#OOO#
###O#O###O#O###O###O#
#OOOOO#OOO#OOO#O#O#O#
#O#####O#####O#O#O#O#
#O#OOO#OOO#O#O#O#OOO#
#O#O#####O#O#O###O###
#O#O#OOOOO#O#OOOOOOO#
#O#O#O#####O#######O#
#OOO#OOOOOOO#OOOOOOO#
###################G#
