#S#########
#OOOOOOOOO#
#O#######O#
#OOOOOOO#O#
#O#######O#
#O#OOO#OOO#
#O#O###O###
#O#OOO#O#O#
#O###O#O#O#
#OOOOO#OOO#
#########G#
