#S#########
#OOO#OOOOO#
###O#O###O#
#OOO#O#OOO#
#O###O#O#O#
#O#OOO#O#O#
#O#O###O#O#
#OOO#O#O#O#
#O###O#O#O#
#OOO#OOO#O#
#########G#
