#S#########
#OOOOOOOOO#
#########O#
#OOOOO#OOO#
#O###O#O###
#O#OOO#O#O#
###O###O#O#
#OOO#O#OOO#
#O###O###O#
#OOOOOOOOO#
#########G#
