#S#########
#OOO#OOOOO#
###O#O###O#
#OOOOOOO#O#
#######O#O#
#OOO#O#O#O#
#O#O#O#O#O#
#O#OOO#O#O#
#O#####O#O#
#OOOOOOO#O#
#########G#
