#S#########
#OOOOOOOOO#
#####O###O#
#O#OOO#OOO#
#O#O###O###
#OOO#OOO#O#
#O###O###O#
#OOO#O#OOO#
###O#O#O###
#OOO#OOOOO#
#########G#
